40 40
410 387
100
3 3 3 3 3 3 3 3 3 3 3 3 3 3 3 3 3 3 3 3 3 3 3 3 3 3 3 3 3 3 3 3 3 3 3 3 3 3 3 3
3 0 0 0 0 0 0 0 0 0 0 0 0 0 3 4 4 4 4 4 4 4 4 4 4 4 4 4 4 4 4 4 4 4 4 4 4 4 4 3
3 0 0 0 0 0 0 0 0 0 0 0 0 0 3 4 4 4 4 4 4 4 4 4 4 4 4 4 4 4 4 4 4 4 4 4 4 4 4 3
3 0 0 0 0 0 0 0 0 0 0 0 0 0 3 4 4 4 4 4 8 8 8 8 8 4 4 4 4 4 4 4 4 4 4 4 4 4 4 3
3 0 0 0 0 0 0 0 0 0 0 0 0 0 3 4 4 4 4 8 8 8 8 8 8 8 4 4 4 4 4 4 4 4 4 4 4 4 4 3
3 0 0 0 0 0 0 0 0 0 0 0 0 0 3 4 4 4 8 8 8 8 8 8 8 8 8 4 4 4 4 4 4 4 4 4 4 4 4 3
3 0 0 0 0 0 0 0 0 0 0 0 0 0 3 4 4 4 4 8 8 8 8 8 8 8 4 4 4 4 4 4 4 4 4 4 4 4 4 3
3 0 0 0 0 0 0 0 0 0 0 0 0 0 3 4 4 4 4 4 8 8 8 8 8 4 4 4 4 4 4 4 4 4 4 4 4 4 4 3
3 0 0 0 0 0 0 0 0 0 0 0 0 0 3 4 4 4 4 4 4 4 4 4 4 4 4 4 5 4 4 4 4 4 4 4 4 4 4 3
3 0 0 0 0 0 0 0 0 0 0 0 0 0 3 4 4 4 4 4 4 4 4 4 4 4 4 5 5 5 4 4 4 4 4 4 4 4 4 3
3 0 0 0 0 0 0 0 0 0 0 0 0 0 3 4 4 4 4 4 4 5 4 4 4 5 5 5 0 5 5 4 4 4 4 4 4 4 5 3
3 0 0 0 0 0 0 0 0 0 0 0 0 0 3 4 4 4 4 4 4 4 5 5 4 5 0 0 0 0 5 4 4 4 5 4 4 4 5 3
3 0 0 0 0 0 0 0 0 0 0 0 0 0 3 4 4 4 4 4 4 4 5 5 5 5 0 0 0 0 5 5 4 4 5 4 4 5 5 3
3 0 0 0 0 0 0 0 0 0 0 0 0 0 3 4 4 4 5 5 5 5 5 0 0 5 0 0 0 0 0 5 5 4 4 5 5 5 0 3
3 0 0 0 0 0 0 0 0 0 0 0 0 0 3 4 4 5 5 0 5 5 0 0 0 0 0 0 0 0 0 0 5 5 5 5 5 0 0 3
3 3 3 3 3 3 2 2 2 3 3 3 3 3 3 4 4 5 0 0 0 0 0 0 0 0 0 0 0 0 0 0 0 0 0 0 0 0 0 3
3 1 1 1 1 1 1 1 1 1 1 1 1 1 3 4 5 5 0 0 0 0 0 0 0 0 0 0 0 0 0 0 0 0 0 0 0 0 0 3
3 1 1 1 1 1 1 1 1 1 1 1 1 1 3 5 5 0 0 0 0 0 0 0 0 0 0 0 0 0 0 0 0 0 0 0 0 0 0 3
3 1 1 1 1 1 1 1 6 6 6 6 1 1 3 5 0 0 0 0 0 0 0 0 0 0 0 0 0 0 0 0 0 0 0 0 0 0 0 3
3 1 1 1 1 1 1 6 6 8 8 6 6 1 3 0 0 0 0 0 0 0 0 0 0 0 0 0 0 0 0 0 0 0 0 0 0 0 0 3
3 1 1 1 1 1 6 6 8 8 8 8 6 6 3 0 0 0 0 0 0 0 0 0 0 0 0 0 0 0 0 0 0 0 0 0 0 0 0 3
3 1 1 1 1 1 1 6 6 8 8 6 6 1 3 0 0 0 0 0 0 0 0 0 0 0 0 0 0 0 0 0 0 0 0 0 0 0 0 3
3 1 1 1 1 1 1 1 6 6 6 6 1 1 3 0 0 0 0 0 0 0 0 0 0 0 0 0 0 0 0 0 0 0 0 0 0 0 0 3
3 1 1 1 1 1 1 1 1 1 1 1 1 1 3 0 0 0 0 0 0 0 0 0 0 0 0 0 0 0 0 0 0 0 0 0 0 0 0 3
3 1 13 14 14 14 14 14 14 12 1 1 1 1 3 0 0 0 0 0 0 0 0 0 0 0 0 0 0 0 0 0 0 0 0 0 0 0 0 3
3 1 2 2 2 2 2 2 2 15 1 1 1 1 3 0 0 0 0 0 0 0 0 0 0 0 0 0 0 0 0 0 0 0 0 0 0 0 0 3
3 1 1 2 2 2 2 2 2 15 1 1 1 1 3 0 0 0 0 0 0 0 0 0 0 0 0 0 0 0 0 0 0 0 0 0 0 0 0 3
3 1 1 1 2 2 2 2 2 15 1 1 1 1 3 0 0 0 0 0 0 0 0 0 0 0 0 0 0 0 0 0 0 0 0 0 0 0 0 3
3 1 1 1 8 2 2 2 2 15 1 1 1 1 3 0 0 0 0 0 0 0 0 0 0 0 0 0 0 0 0 0 0 0 0 0 0 0 0 3
3 1 1 8 8 8 2 2 2 15 1 1 1 1 3 0 0 0 0 13 14 14 14 14 14 14 14 14 14 14 14 14 14 14 14 14 14 14 16 3
3 1 8 8 8 8 8 2 2 15 1 1 1 1 3 0 0 0 0 0 0 0 0 0 0 0 0 0 0 0 0 15 0 0 0 0 0 0 0 3
3 1 1 8 8 8 1 1 2 18 1 1 1 1 3 0 0 0 0 0 0 11 0 13 14 14 14 14 14 12 0 15 0 0 0 0 0 0 0 3
3 1 1 1 8 1 1 1 1 1 1 1 1 1 3 0 0 0 0 11 0 15 0 0 0 0 0 0 0 15 0 15 0 0 0 0 0 0 0 3
3 1 1 1 1 1 1 1 1 1 1 1 1 1 2 0 0 0 0 15 0 15 14 14 14 14 14 16 0 15 0 15 0 11 0 0 0 0 0 3
3 1 1 1 1 1 1 1 1 1 1 1 1 1 2 0 0 0 0 15 0 15 0 0 0 15 0 0 0 15 0 15 0 15 0 0 0 0 0 3
3 1 1 1 1 1 1 1 1 1 1 1 1 1 2 0 0 0 0 15 0 15 0 11 0 17 14 16 0 15 0 18 0 15 14 14 12 0 0 3
3 1 1 1 1 1 1 1 1 1 1 1 1 1 3 0 0 0 0 15 0 15 0 15 0 0 0 0 0 15 0 0 0 15 0 0 15 0 0 3
3 1 1 1 1 1 1 1 1 1 1 1 1 1 3 0 0 0 0 15 0 18 0 17 14 14 14 14 14 14 14 14 14 14 16 0 15 0 0 3
3 1 1 1 1 1 1 1 1 1 1 1 1 1 3 0 0 0 0 15 0 0 0 0 0 0 0 0 0 0 0 0 0 0 0 0 18 0 0 3
3 3 3 3 3 3 3 3 3 3 3 3 3 3 3 3 3 3 3 3 3 3 3 3 3 3 3 3 3 3 3 3 3 3 3 3 3 3 3 3